###############################
#p   s **1*    *   *  * * *   #
# # # #*# # #*#*# # # #*#*#*# #
#   *     ***  *      *   * * #
# # # # # #*# # #*#*# # # # #*#
#f         x **  *  *         #
# # # # # # # # # #*#b#*# # # #
#*  *      *  *   #  *    b   #
# # # # #*# # # #*#*# # # # # #
#*    **  *   3   *           #
# #*# # # # # # #*# # # # # # #
#           *   *  *          #
###############################

Info Tiles:
# - Wall
* - Brick
x - Portal

Mobs:
p - Player
1 - Balloom
2 - Oneal

Powerups:
b - Powerup Bombs
f - Powerup Flames
s - Powerup Speed