###############################
#p * *3   s   *  ** * *      *#
# # # # #*# # #*# # # # # #*# #
#f   * * *** **  5   *    **  #
# #*# # # # #4# #b#1# # # # #*#
#          *     **      *  **#
# # #*# # # # # #*#*#*#*# # # #
#   *        *   * *x* *   4  #
# # # # #*# # # # # # #*# #*# #
#   ****         *2           #
# # # # # # # # # #*# # # # #*#
#  ** *5  *    2              #
###############################